#############
#O    PX    #
####      # #
#    X     O#
#           #
#######   ###
#          O#
#  X        #
#           #
#############
