          #
         #P#
        # X #
       #     #
      #### ####
     #         #
    #       #####
   ###    X   #O #
  #O              #
 #                 #
#####################
